>5af53b32-9704-45ca-a6c8-20ca43a7c2dc:LomanLabz_PC_Ecoli_K12_MG1655_20150928_MAP006_1020_1_ch2_file1_strand:0
TTACCGCCACGGTGCTGCTGCGCCGGTTGAACGCGACGGCAGTCAGAGGCGACTGTTGTGGGGTATATTCGATTCCGGGA
TACCAACACTGTCGAGTTCAGCACCATCTGCATCATCCACAGCGTTGACATGCCGACAACAGCATCTCATCGGTAACTAT
CCGCACGGAAGCACCTCTACGCAACGCCATTAGAGGCATACGGGGAGTTCTGCTAACTGCGGCCCTACACTTTATGGTTC
CAGCCCACTGGAACCTGAACGGGCGTGGCGCCTCAGAGCGTTAACGTCTTAGTTGCGGGGAGCTATGTCCTTAGTGGCTT
CCGGAGTGCTTCGCTTAGACACAGCAGCCCGTAAGCGACGCTAGTTTATGCGGCCCTGTACTTCCGTAAACAGCCCATTG
CTTAGCAGAGCAATCGAATACTCTTTACATTGCGCGCCAACCGACGATGGCCTAAGGACCGTGATGGTAGAAGTCGGGCG
TGTCCTACCCTATGTTATGCTGAGTTTATTAGGCAAGGCAGCGAGGATGTCAGCATCTTGTCAGTGTGAGCAAGCCGGGA
ACCTGCGCTAGGCCAGCGCCCTATTTCTGCGCACATTCGCCGGGCTGCTTCCGCGACCTGTAGGAAGACTGGGCTTTCGG
CGATGCCGCGGGCCGGCTCCTGCACAAGGAAGCCAATTTTCCTAGTATATAACCTCGCCCTGCCGCGCGGTGCTGCAATC
ATGTGCCGGGTTGCCCACGCGTCTAACGCGTGTCATCGTGCGCAGGCCTTTGGATGCGGACGAGTTTGGCTCTCTACTCT
GAAACGCGGTTTTTGCCAAATCTTCAGGACTTGAAGCACATGCTCCCACTAGTTGTTGTGCCATAGACCGCTCGTGTCCA
ACAACGAATTCATAATGCTTGCTGTCAGTACTCCCCCACTTACGCCAGCCCAACCAGCGGGATCGTGCAGCAGCGTTATT
GTATTTCGTTTGCACACGCTGAAGGACGGAAGGACCTCCCCGTAGATGCCACGGAAGTGGAGGCACAGTTGACACGTACG
GAGATCGGAACCGCCATTAGCTGGTGCCAGCCCCGATGCGTTACCGTCAGTCGACGAGATACACTTTAATATTATGGTTC
AGATTTGCGAGAACGTCCGACTTGCCGTCTTCCCAGGGCCTCCACGATCGGCGGTAATCTCAGAAAGACCAGCCGATAAT
GAGGACGGTCGGAGCTGAGGCAACAACCGGCCGACAACCTGGTTGGGGACGTAGAGGCGGAGGGTTTTGCTTCAATGTTG
TCGGGGTGTGCCCCGCAAATAATGTGGTTTGGCTTTGAGTTTTGAATCCTAGTAACCTCCTCGTACGGTAACGTTTAGAT
GTTCTTCCATCTGTCAGCCTTCGGCAATAACCCCAGCATGTGAAGTTGTAGGGCGTTGCGTGAAGTGGCTGAAGGCGGTA
AGTTATTCAACAACGGAAATTCCAGCAGTACAAGACAGCGTAAGAAATGATATAAAGCGAACAGGTTTTTTGTTGGTTGC
GTCGCCTCTTTGAATATCCGGCTCTCTAGGCTTTATCGTCTTTGTAGTTACGCCAGCGTCGTGAGCCTCAATAAGCGACA
ACAGCCCATGCGCAGGCAAACTGTCAGTATTCATTGAGGTACTGATGACCCATTAGTTTCAGGGGCGTTATGCCGGTTGT
AATGTGGTCCTACCCTGCGGTTGGACATTCGTAACTATTTGTCGCCACTTGCCGAGTTTGTAACTTGCTAGTCCAAGAGT
AACGTGCCTGACGGTTCGATTTCATTCTTAACTCCCTGTAGTGACTAATTTTACGCGACAACGCTCCGAGGATAGAGTTA
AAACCTAATTAGTGCCAGTGAAAGAGCACCTTAGGCTGACGGATGGGCCACTGACCACATAATTGTAACGTAGTTTGCTG
GCTCTCCTCGGAGGTTCTTTATCAGAAGCTTTGGGCGTTATGCACTGAATCGAATTATATCTTCCTAGTGACATGCATGT
AATCGTTAGAGAGCCGGTGCTACGGGCAGTAGCGAGCAAATTTATGCTTTGAATTTCTGCTGATAATAAGTAAGCCTGGC
TACTTCTCGTGTGTGCTTGATTATATGTGCTACGATGATCGAACGTCTCCTACATTGAAATGAAAGATTGCCATTCGTCT
TAGATGCTGCTCTTGTAACCTTTGACTTTGCTACCCATGATGTCATAGGATTACTTCATCTGGGTGCTCGATGTAAACTT
GGGCCATATGGTTGATACTCTTCGAACCTATCCTTGTAGGAATTGGGTTCTCAATCCGAACACTTTACTAAAGTTTTTAT
TCGCAATATCATGCTTATCCTCGTGTATTTCTCGTAATTATAATTTCCTTTAGACCTAGGGAGAGCATAGATACCGGTGG
AGCGCAGGTCAGGCGCTGGGGGAAGGCATCGGCGGGAAGGGAACAATATCCACGAGTGGCGTGGCTGACGAGCGCGTATG
GTATGGATTTAGCCCCGTCTGCAAGCGAGGGAACCAACCCTGAATGATCTGGCGCAGGATCCCGCATGGTTCTCAATCAT
GCTTAATGCTGGAAGCGGGATTACACAGACATCGATTATGGGGCCGATCCTGGATAGATACATTAGAAGTTTTGCGATTA
CGAAAATGGAGCAGTAGGCGTGAGTTACGCTTATGCCTCTACTTTGTAGCAAAATGCGGCAGAAGAGTCCCATTGACCAA
GGTATACTGAAAAGCGGAGATCAAACATTACCAAGTTGAAAATCGTAAGCATTCATGACGCGTCAGGCCAGTGTACACGA
TCAGATGCGTGTCTCTACCATCTCCCACTAGAGCACCGGAGCTCGTCCGTCTACGGTATGCTGCTTGCTATTACAACCGT
GATGCCGGGCGGCTTTCGTAGAAAAGCACCCTTGCGGCAACGTGCAGTTTCCCGGACGCAGTGTACCGTTTTTACGTAAT
GAATTTGATTCCTCCAGCGTTATCAATGGCGAAGAGGAATGAGGGCTCGTCATATCCTCAATGTGCAGGTGCGTCATAAG
CTGCTGCAGTGCCCCCGTCACCAATCTGCCCAAATACATCACCGCCACCCAAACCGCTCATATGACGTATGGGGGACGGT
GTATTGAATCAGCACAAAATCAACAGGTTATTCTGGCTTGACGAACCTTACATTATCTGCGCCTGAACGGAGATATCTCA
GCGCAGATTGGCTCATCGGCGCGTAGCGTCAGGCTGCGAATTACTCTGAAATGGCAAGTAGTTTGCGCGCGTACACGCCG
GAACGCATGAGGCAGGCATTGCAACCTCCGGACACGAGCCCACCTGCACAGCCAACGACATATTACAACGACTAAAATTG
TTTGGACGACGGTAGACATGGAGCGGTTTAATCTGGCTGCCACACCATCCACCCAAGATTAAACAGCGAAGAAGCGGTAA
CGAAAACACATCTGCGCGACATCCGTGTGAGCCGAATAATCTGCGCGTGGACCATTCAGCAACCGGTAAAGCTGTGCAGG
GTGCTTTGCCGCAGCCTGCTCACGCCGACGATCGCCCAATTCTACCACGGCGTGATCGTAGAACTACATGTAATGGCAGC
CATACTGTTCCGTGATTTACCAAAGCGATTTGAACCGGGAAGTGCTCTCCTTGGGGTACTTGCCCTCTACTGTTCGACAC
TGCTCTACGTGCTGCCACTATCTCCAACAGGCGCGCACACTTGTTGGTCACCACGTGTCACCTAGATAAGTTCACACTGT
CCATGAGATAGCAACATCCCCCAAGGGCGAGCGTCAGGCAAATCAACCGTCATCTCGTCCGCTGGAATGGCAGCTACCTG
GCGTGGTACTCTAGGTTTCTGATCTCCATGCGGCGACCCAATACTGGGCCTGCCGGGATGATGGATAGCTTCTTAGTCCG
CCGCTTTGGATCCCCTTCCGGCACTCATCAATCAACGCTATCGGAGTTGCGACACGGCGTAAATAATATATCAGGGCCAA
CCGCGAGTTCTCACTGGCGCGGCTTCTGTTGCTACATCGCAGTACCTACTGCAACTGCACCGTACCTTCTGGGACAGCGT
AGTCATTCTGCGAACAATCAATTGCAACGCGGAGATCCGCACGAACCCTTACCCGCTGAGCACAGGCCCTAACGAGGCCT
CAACAACACAGCTATTTTACACGGGATCAGGATTGCATCTCTTCGCACAGGTCATGGATTGCTCTGGGTTCGCGACAACT
TATGGTCGTGTATGGTGAGATTACGGTCAGGTAAACTGGGAGGTAATTCGCTTGCTTGAGGATTACTATGCTTTTGGGCC
TAACGTAGATACGACCGGGCCCCCCGCGCCACTATGACACAGAAGCTGTTAAAGATTCAGACATCTTCTCCCAGCATAGG
AAATCTGCCCCCGATGTACGCGATAACTGCCGTCAACCAGCATAATCAGCATTGCGGTATGATTACTAGCTACATTCTCA
GCCCAGACCATAATTCACCGCGGTAGTACTTAAGAGCATGTTACACCGTGAACGCCCCGTTAATAACCGGGGAGGGCTCT
AAATGCAATTGTGTTGTGAGTCCGAGTAGACTTAGTGATATATGCTTTTTGGACGGTAGGTTTCAACTTAGCGAAGTGAA
TGGGATAGCGGAGATGATGCTGAAAGGCTGAGCAAGTGAGTCGAGAGAAATGCGCAATACCACTATCGAGTACATAGGTC
CAGCTCATTGCTACCATCGCCCCATTAGGCCGGCTTTGTTACGCCCCGAGGCCGGCTGTACCCAACGTACCAACGGCCGG
TAGAACCCCCGCTACCATCCAGCATTAATGCGCGTAAGCGGCGGTAGGAACTTACGTAACCCTCCTTAGAGTTGATGAGG
TGCCATGAGGCCTAAATTTCGCCGCCTGAACACCCTCTCTCTGGCGTACATGGATCGGTGCCGCACAGGGCCATAGGAAT
GCGCACGACCGCGGACGCTAGACCCCGTCAACAATAAGCCGAGGGCATAGAGTCCCCCTTGCTGGATAGAAGGAGATCGA
CAGCATAATGTCCGGCTTAGAACCTTATGGCGTCTGCGCGTCACACCATAAGAACGAACTAATCATACCCGCAATGGCAG
CCGACTAATGCACCCGCAATGATTGCTGACTGCCGGGGTCACCCCTCGGGATCGCGTCAGGGTTGCTAAACGTGACAGAT
ACGATTAGGGGCGGGAGCATAGGCGGGCACGTCAGTAGAACTCCGATTCGGAATCATGCGTCGCCAGCCACGGGCTAGTA
AACATCGGCTTAATACATGACTGATGCCTGGTCACGTAGGCTATGCCTTCAGCATCCATACCAGTTGCACCGTCCACTGC
GTTGTTGAATCTCGGCTATTTCTGGGACGACATAGGACGGGGTTATCTCTAATGATTCTACCTCTCCTTTAATCTACGGC
TCTTACTAGCTTATCCGCTCAGCAAATCCACCACCGTGACCTAGCACTAGCAGATGAAATACCCCCTACCCCAAGGCCCA
ACCTGCCGGGAATCTGCCCCTCACGGTATTGATGTTACTACCGGTGAGGCGTCGAACCGGCAAGACCTCCGTTACCTGAG
CACTGCACTACATCGACCCTATCACGCGCCCCCCAAACCCAATACGTAATCGATGGGGTCAACGCATTGGGGCGGCCGGG
ATATACCAGCCGGGCGAGCCCTGGGATGAATGGAGAGAGAGATATCCTTGGTCCCTCAATTGTTCCGGGGTGAACAGCCG
GATGATCTGGCGAGCAGCGTTACGAACGTAGCAGCCGAGCGTTAATGCGTAAAACCATCTTGCAACGCATTGAAGAAGAC
TTTACTAGTTTGACATTCAAGCAGCGCCATCGAGCAGAACAAAGCGGTAGTTAGAGTTCTGAAACCAGCCAGTCATCAGC
CTGTCCGCCACGGGAGTTGCAGGTGAGCAAAGCACAATGGCCCCCAGCCCAAGCCAGAACGCAAGACTGTGGAGATTCAT
CCTGACCGGTATTTGACGGGGTAACGTACAGCCAGCATTCGCCAGGTGCAGAATGCCCAGCGGCTGCCAATGGGAATGCC
AGCAGCAGCAGCCGGACGAGCCAGCGTCGCCACGGGAAAATAGCCCCGAGCTCTTCCATAAGGCCTCACCATCCCGAATG
GATGTTCCCGGTAGCATGGGAGCCGGTAAATACTGACGAACCTATATCCGCTACAGTATAATGCCATTTCCCAGTTGCTG
GCAGTATTTCCACAACGCTCCTGAGCATTCGCCAAGAGTAACGCGCCGGGTCAAAAGAGGGGTCAGATGCGACTAACATC
AATCGCCCCCGAGACACCCACACGAGCAGCCCCAGCAGCGTTGGCTGCGCTCACACTCTCGAGAGGTCAGTTATTAACAT
GGTATGCAAGCTGTTCCAGCATGGCGGGCTACCAAAGCCTTCACTTTGTTCATCGCCAGTTGGTAGGTTTGGGGAGCCGA
CCCACGACAGGCACTAGTCCGATCTCTAATTCTTGCCTGCTGGTAGTCCCAACGGGCTTTATTGCTTATCCCGAGGCGCA
TTGAGGATAGCTCGTATATCATATAAAGTTTCGGGCTGCTGGAGTAAGTTACCCGGCAACTTTGTGCTCATGGATACGTG
CTAGGCGGCCATTACCCAAATCTAGGCGCTCCAGTGCCAATCGGGTCCTATCGGTTATACCCACTCATTGCCCATGGTGA
ATGCACGGTTCCATTTCACAATACTGCCCATAGGTTCGACTGGATTGTGCCCCCACCGAACAGCATACGAGTTCTGGATC
GTTATCACAGGATAGGAGTAGTCGATAATGACGTGTCAGCCTTGGGTCCCATTGTGAGCTTGGCTGTTACGTTGATCCTG
GTTGTATTGGAGTGCGTCGCGAAACGTAGCCGGTGCCTTCAGAATGATCGGGCCGCATCTGGTTCGTCGCCTCAGAATGC
GTTAACCATGCCCTGGATCGGTAGACCAGGAAAACTCGCGGGAAGTGCGCGTAGAGGCACAGTCGCTGTGCTTCAGATAC
AGGTACAGCCCTCTAAGAACTCTCTATAGATACTACTTAAAGATGGGTTGGTTTTCGTATTCGAGCAGTTATGCCTAAGC
AGCGCAACGGCAATGTCAGGGTCGCCGCCGGGATGGGCAGGCGACATAGGAGGCGGTTCGCCCGGGGTTTGGGATCTCCC
GTTTGAAGTTCAGTTATTGCGGCTGCGATTGGCGCCAGAACTAATTAAACTCTTTGCGACGGTTGAGCATAGGTGGTTAG
AGGTGAAGCATGGTATTTGCGCGAGGAAGACGGGGGGCGATAATGGATGCGTGTCAGTCCAGCCGGTAAACCGTGAGACA
GTCATTCACAGCATTACGGAAACCATCTGAGTTGGCGCACCTGGTCAATCTGTTCGTCGCGAGCATCAATGGTCTTCGTA
TTTAGGAAGACTTATAATTCTGCCTGGCCCCTGGCCGATTTAATAGCCTAACAGCAAGTTTACTATCCTGCCCCAGTACA
GAACTGCCATGAAAATGCTCGGTATGGTTCGGACTATTGCCTCTTTGGTAGTCCATTTTACAGCTACCTTGCCGATACGC
TTGGATGCTTGCTCGTCCACCGTCCGTTGTCTTACCCTGAGGCTGGGACGGGTAAACCTGTCGAGTCGTTATTATCACTT
ACCCCCCTGATCAGAGTTGTACGTGCTGAAGCTTGAAATACACAGCGACTGGTTTATGGTAAGCGGGATTAGGCGCAACC
GGGACGGGAATTGGCGAGGACAGCGCGAACGAA
>5af53b32-9704-45ca-a6c8-20ca43a7c2dc:LomanLabz_PC_Ecoli_K12_MG1655_20150928_MAP006_1020_1_ch2_file1_strand:1
AGTCGTTACGGATTACCGCTAACGTTATGCCCCGCCTGTGCATTGCACACTAGGAGATTAGCGCCAACTGCTATCTATTG
GTAAAAGCGCCGGGCCAAACCTACATGAAGTAGGCTACTCACTCTAATCTACCGTCTTATCAGCGGCTGGTTGCCGCTCC
CACTCCTTATAGACGCTATCGCACCGTGTAGCAACAGTATCGAGTAGCATACGCCGTGGTGAGTTACGACGAACTCTGTC
AAAACGCCGCCTACGTAGTTGCCATCCATAGGTTCTCTATCCGAGCGAGATCATATTTCTGTTTATAAGCCTCAAAGTAA
CAGGGGCACCGTTCTCTAAGATTAGATTATTAACCACACCAAGAACAACCTGCAGTTACCTGACTAGGCTATTCAAGCGT
TCTACCTATCCGATGGCCTGCGGCTTATGATCAAGCGTCTGCTAGGATGCGGCCATGGTAACGCCGCGGTCGCCCACGAC
ATACCCCCCTTTTAAAGCCGGTTACTTACTCAGCTGGCGCCTGCCGATTAGTTCTGTACAAATCTCGCGTAGCAGGCAAC
ATCCGAGTTAATAATATCGGTAAAATTATCTCAAATTACTCCCGTCGCCTGCGACTCCGTACCGACATTGGACAAGTCCA
TTAAATCGTAGTGGGCTCTAAAAGGCTCAGGAAGACCATTGGATCTCATCCGTGATCCACGTCTATCTGTATCTCAACTC
TACAGGGCCGGGTCGGGCCTGGATGTATCGTCATCCCCTTTCCTGGTCTACGATCAGGGCATGGTTAACGGCATTCTGAT
GGGTAGAAAACAGATGCCAACCGTCGCCGCAGGCATGCTACATGCGACGCAAACCGACTGGATACATGGGATCGCAGCCA
GCCGAAACCCCTCTAACTCAGCAAACCTACATACTCTGTCTCTACATGGATCCATACCCAACACTTGCTCTGAGACACAT
GCGATCTCCTCCTACTCTCCGAACACTTGAAGACTCGCAAAGCTCCAGGCCAGGATGCGCGACAAGTATAATATTATCCA
CTGCGATTGGCAACCGATCCCACGCCTTTGCCATACGTATGTTGAATTGATGTCCGTACACCTGTATCAAACTAAACGTT
TAGCAGCCATTAATCTAACGTGTCTATCAAATGCCTGCCTCACCATCGACGCGGCTGCGGACTACCGACGCCAGGCGCCA
CTTGGTCCTGCTCCTGCTGACTGTGTAGCTGTGCCCAAAACTCTAGACCCGATAAACTCACGAACAAGTTGTTCGTACAT
GCTGGAACAGGTCTTCTGCCACTCCTCAGGCTCGACCTCTTATTCTCGATATTTACCAACGCTGCTCCCGCCTTAACGTA
TCTCAGCGTCTGCGTACTTACGTTTATTATCAAACTGTAAAATATTAGGCCCCGTATAACTCAGACTGGGACGAGGCGAT
GCTATCGTGGAGATGGTCAGGGTATACTAACTGATAAAGTGTATCCCTTTACCGCCTACGTCGAACGTTGAACTCTGAAA
CATTGATCGCGGCGTCAGTGGGCGATCCCTGACTTTTTCTCACATAGCTGGAGCTCCTTTTGATCGTAGTCAACCAACTC
TGATTGGCGTAAAGACCCGACCTCTCTCTGCATTATCGCGAACCTGGCTGGACGTAAACTGTAGAACTATGGACGTACCG
ATGACAAATCGTTTATCAATGTACTGGCGTCATTGTCGTGTCTCTTATCTGCCTGTCGTCTCCGGCGCATACATGGTAAC
TCTGAACCTACATACATGTCGCACGTTATCTGACATTAGGTCCTTGAAGCAGCCTGAAGTCTTCTTGATGCGTCTCAACA
TCTCTCATCTTACTAAGCATTAGCCCTGGCGTCGTGCCCTGAAGTTAGCCCGCACTGCACCCACGATCCTGGAGCGTGGC
TGGCGACTAAATGCTTACACGTAAGGGTGCCCAGCCTGACCGCCCTTTATGTTATCCCTCCAATGCGTTGGTGTGTGGGA
TTGGATCTTACCTTGAAAAATAGGCGATTTGTTATGGCGCATCTTATACGCATCCGTTGCTGGCGCATCTATTACTCTAC
TCTAACATCTCAAGCAACGTCTAAGCATGGTAGTCAGTCGTGGTTCATTCCTTATGTGCTATTATATATCCCTTCTCTTT
GTGATTGTATGTAAGATCGGTGCGAGTATCGCTCTGCTAGCGGAAGCTGTCGCTGCCCGCCGACCAACGAATTTATAATC
CACTCTCTGGGCTTACTCGACGCAGTTAAAATAGATCTCCATAGATGACGTCGCTGTGGAGGCTCTTAACTAGCCCGTGA
CTCGCTTTTGCCCTTCTGCACCTCAATATGTTGGCACATCCCCATGACAACGAACTGTCCTCCTAGTATATTAGCAATCC
AATGATTCTCGCTTAGTGGTTGGCTATTAGGTGTAGTGGTTCCGGACTAAAGTTATATCCGGTGCTTGGTAGCACAGCCC
ATCATCATGCGCATCAACCTCTATTATGCTCGTGCGTCCCTTCGTTGGTATACGTATGATAATCGACTCGGCCGAGTTGT
TTAACGCCTGCTCCTCTGCTATTGTGCCGATTCTACGGTTTATGCTAATGCCTAGCGGAGCGGTACGTGTACTAGTATAC
CGCCCTGTTTTCAAGCGCAAACGTTACCACGTCTCGGTTGGCATGATCGACCCTATTTTGCTCTCCTACTAAAATCTGTG
CCAACCGAGTAGGTAATGGTAGCATTTGCTCACACGTTACCCGTCTTGGCCTGGGTCAGGCTCCGAGTGCTGAATGGGGC
GCGATACCCGCTCTTAAACTATGTAATCCTAGTGGTACTGCGCATTTGCGCCTAGCATCTTTGCTTACTAGTCGTGCTGT
ATATTTGGTGGTCGCAATCGTAGCAGCAGAGGAAGGATTGGACTCGGCGTCTACCTCTTTTGTAATAACTTGGCCATTCC
TTTCTCGCGGTTTTATAGTATGTTGACAGGCTCACTTGTTGAATGTGACTCGCATGCAGTGTGGTCTGACCGAATGCTCG
CTCGGGCTTACCGCAATCTACTTATTAAGTCTGCTACATAGCTCCAGTTATTAATCTAAACGGGGGCTGTTGGATGCTGG
GAGGATGTTGTAACTACAAAGGCAAAACATGCTTGTCCCTGTATCCCGCGGCGCGCCATGGCGATGGTGTATTCCGAAAC
ATCTCTAAATGCACCTTCAGGTAGTGTCAATGGTATAACTTGTGGCCGGCTCGGCACATACATGCGTTAGGCATACATAT
AGCCGGAGATCCTTAACCGCGCAGCAAATCTAAATCGTGGAGGTTATTAGTACGTTTGATTTCGCTCTTTTGACCTGGTA
GTCTGTTAACTTGGGGATTGCCTGCGAGCCGAATTGGTATTGCACTAGTAAGCCTACAAATACGGTCACGTGAGTCCCAA
ACTGCGTTTCGTAAACACCCTCCCCCACCGGGCTGGTGCGGTTCTGTGCTACTAAATATCGCTTGTGGAACTTGCACTCG
TTTACGTGGTGCCGCAACATACTTGAAAGCGTGGCAGACGGTCTCCATCATCCCGGCGTAAATCTCCATTATTTATGCAC
TTAGGCTCTGAGTACCTACTAGCTATGCCCCCTTTAAAAAGTGAACCTACCCGGTTAGTACTCGTAAAGTTCGGCGTACT
ATTTTTTGATGCCTCAGGTGCTAGTGTGAATTTCAACGCTGCTAGTTGGTAATAAACAGACATGTGCTGTTGTGGTATCT
CGCAGCGGAATGTATAAGTTATAGTCTTACGTGCCCAATTAATACATTTTAGATACATCCTATACTGTAATATAAAGCTG
TTGCACTTATCTTGGTCAGATGCTAATTGGATACGTAGGGGTCGTCGGCGTGAGCGTAAGCAAGGCTACACCCCTTTTAG
TACTGCTGCATATCGCAACGGGCGGGCTCCGTTCTCTATGGGTGGATGTGTATGTGCAGTAGTTTCGACCCTGATTGCTG
CTGCCGGTATAAATTGTACACATCATCACAAGTAGATATCTGAACGCCTCGTAACCTGGCTACTGAGCGAGCGTTGGCGG
AGAATTGACATCTTGCCTGGGTTCGTTAGATATCATATAAATCGGCTGCGTTTGCCGGCGGGGGTAGTACGCTTGCCCAC
CCTCTCTCTTCGCATATCGTATTGTGCTTATCGGCTGGGTCAACTCTCTGGCGTTTTACGGCGCGGGTCGCCGTACTCTC
TAATAGGAAGTACATCATCTATGTGCTCTTCGCCATATGTCTCGTAAGTCATCACCGGGTCAAAACCGTATATCTCCTGA
GATATTGTGGCTCAGCCACGGCTATCCTGATAGATGCTAATACATACACCCGATTATTGCTCCCTCTTCCTATACGCTAA
GTCTGGTAAGGCAGAATGGGCAGGTCAATGAACACTGTGTATTACGGGAACCGCGCCTTTGCCCAAACATGTTTTCCCAT
GGTCACGGCATAGTAAAGGGCCGGTGAGTCCCAATCGGTACCAGCCGCCCCGACGACTGTAGGCCTCCGGTGCTGGCATG
AGGTTACCGACTTAACTACGAAACTAGGGCTTGCCCACCTGAGTCATCAGGCACTTATTCGCGTCAACTGGTAATGCCAT
CGTCACGTCAATGGGCCAACATGATGGTAGTTTGCTTTCCATGTATGTAGATGTGCTCGCACGAACAAAACCTCAACAAG
CAACTTCCTCTTCATCCGGTCCTTAGAGTGGAGTAAAGTTATCCATAATACTCGGTGGCTATCGATGTTGACGATGCGTA
CATTCCCCCCTCGTGTAATGAGAGCCCTAAATCGAGCTGCGGCGTAAAAATCCGCTGAGTTCTTCGATCTTCTCTTTTGC
CCTGTCAAACTAATTGCTTACAACATGTCGTCGACGAGCGTATAGTATTTCATTCGCGTTTGGTACATTCGATGTTGTAG
TACTTTCTTATCTCATTGTCGTTACTCTGTATGAACGACGGAAATTACTATATAATGCCGAACCTACGCGGGGGTGTCTC
CGATAAAATGTAAGCCGACTTACTTTAAGTATTAGTCCACGACCTTAAAGGGATATAACCCGACATTGTATCAACTGGTC
AATGGGTGTACTCCAATCTAAATTAAACCATCTGGTGTCTATATAGTGATACATATAATCTAACGATAAGCAAATATATT
CATGCTGAGTCGTCTCGGTATTAAGTGGTTGTAGTAAGCACTAACTCACATAGAGATCTATGTTGTGGTGGTGGTAAGCA
GGATTCATACAGTAAACTTGATGCTGCCCCGCCCTCCCTTCCTGAAAGATATGTGTCGGCGGATGACATTAAACCTAACC
CTGACGTGGATTCTGGACATGACAGATCTATCTACAGGGACCGTAAAAAATTGGTGGTTAATCTTAAAGGGCCACCGCTT
GCCCTGACTGATCGTGAAACACGTTACCATTATAGTTCTTCCTCCCTCGAGTGTTATTAAATAGACACCCACTGCGCGAA
ACCTATCGAGTGAATCGTCAGCCATGCACTTCTGCTCTCTCCTATTTAACCCTCACATGATTAGAGACTCGCTGCACGTA
ACATCTCCGGCCAACGCGCGATAGACAGGCTAACTATTCAACCAACCGTGACGACTTGACAGTAGCAAGTTGCCTGAAAT
GTTTTTGTTATCTGCTTATACTTAAACGACTAACCATGAGCAGCGCCTCCTAGCCCCCACGAACTATTCACGATACATCT
CTGGCGTAAAAAACGACATACGTGCTTGGTGATCATATCTCCTGTAACTTATCAACCGTCGTTGTTGAACAACGAATTAC
GTCAGCAAACCCAGCCGTAACTTCAACCTTACCTGCTTAAAGAATCTTGCATCCAACCATACAACATCAGAACGTGAATA
AAGGATTTAATATCGCAATCACCTCCCCTCTATCATCCTCCGACGGGGATCTAAAATTTTACCGTATCTATGATGATATC
TGACATCTGCTGTTATTTAACGCCAAACTCACGTTGCACAACGTGAGCGTCTGAGGTCACGTTCGAGTTTTATCTCTTAC
CAGGCCTCAAAACTGACGATTAAGACGTGCCGAGATACAATCATGATTGTGTATGGGTCAACCCATTCTCCGGTGACCGG
CATCGGCGCTGGGATTCAGTACGTAATATTAACACTAAATGTGAGGGCTCCCTCCATCTCTCTAGTTGCGTATGTACTCC
TTCAGGCCAGCCTCCGGCTATGATCTCTCTCGGTATAGATGTATGGTAATGATCACGTACTATCACGATACTATGAATCG
TTGATGAATTTATCTCAGCTTGAACATATAGATGGATGTCCTGTTGCAGTTTGGAGACTTTGCTAGATCCAGTCAGTTGG
TAACTAAAATACCCAATGAAATTTGTTCTTCTCTAATCACTGCACGCACTGCGGGGACTCGTCACATGATCGGAGGCTAC
ACACGGCTCTGCGTCAACAGAAAAATCGTGCTGCCAAAGTCAGCGGGCGGTCCGAAATGGTGCTGGCCAGACCCGACACA
GGGAATGCAGGAGCACCGGCGAGTCTTTATATTGATCGGTCTGAGTCATCTCATCCGAACCTGATCATTTTAAACAAACT
GTAGAGGCCGAGATGGATCTCTCGCGTAGCACGCCGGTGCTGTCACTGCTGGATGTATTGAGGTGCTGAAGATTCTATTA
CATTACCAGCTCGGGCCTTTTGGGGCAAATGATGGGTCCATGCGCTCGTGCGTCCATGTGATGCCGTCGACTCAGACGTC
ACCGTGGAAGCCACGCCCAAGGTGGCTATATGAGATAACGCAAACTTACCGCCCAGCGTTTGCTGCAGTACTCAGAAAAA
GCTGACGGATACGCGTCTACTACCATTATTGCGGGCTCCTGATTGGTCGCTTTAAGCGTGACAGTATCACATCCGATAGT
ATGTTAGCAAACCAGGCCGATACACAGTATTCACACATTCTTAACGTAGGCTATGGTACTGCCAACCGACATTCCGCGGT
GACCAGGATCCGTTTTGCATTGCGAGATACCGGAGCAGCAAGGGCTGTGAAAAGC
